1111111111
1222222111
1252222111
1222212221
1221112221
1221222111
1221222222
1221122222
1222211111
1222222111