1222222221
1111222221
1212222221
2211112211
2212222221
2222212111
2222212221
2111111121
2222222221
1111111111