1222222221
1112222221
1221111211
2221112221
2222222221
2221112221
2221112121
1222222221
1222222221
1111111111