1112222221
1222222221
1221212221
2211212221
2222212221
2221212221
2222222221
1222222221
1122222211
1111111111