2222222221
2122221221
2212222121
2221222211
2222122221
2222212221
1222221221
1122222221
1112222221
1111111111