1111111111
2421224141
2221221121
2221222121
2221222121
2221222121
2221222121
2222222121
2222222221
2222222221