1222222222
1222222222
1111111111
1111112221
2222222221
2211111221
2224214221
2222212221
1422211111
1112222111