1111111111
2222212211
2121222221
2121411221
2121112221
4222212121
2121212221
2122211121
4122222221
1112222111