1111111111
4241222221
2221222221
2121222221
2221221221
2221421221
1211111221
1222222221
1222222221
1112222111