1112222111
1222222211
1232222211
1222222212
1222211222
1222211322
1222211222
1232212221
1222212221
1111111111