1222222222
1222223222
1221111211
1121111222
1131111223
1121111222
1221111222
1221222221
1221222221
1111111111