1112222211
1232223221
1222221111
1221222222
1221222222
1221222222
1221221111
1221222321
1221122221
1111111111