1122322111
1121212111
1122212111
1111112112
1232222223
1211112112
1211112112
1211112111
1222222211
1111111111